# ABC
Α-α	Άλφα // Alpha - A as in Ant
Β-β	Βήτα // Veeta - V as in Vase
Γ-γ	Γάμμα (Γάμα) //Gama - γ or g
Δ-δ	Δέλτα //Delta - ð as in THe
Ε-ε	Εψίλον //Epsilon - E as in Element
Ζ-ζ	Ζήτα //Ζεετα - Z as in Zoo
Η-η	Ήτα //Eeta - EE as in sEE
Θ-θ	Θήτα //theta
Ι-ι	Ιώτα (γιώτα)//Iota - EE as in sEE
Κ-κ	Κάππα (κάπα)/Kapa - K as inCow
Λ-λ	Λάμδα//Lambda - L as in Lemon
Μ-μ	Μυ (μι) //Mee - M as in Mother
Ν-ν	Νυ (Νι) //Nee - N as in North
Ξ-ξ	Ξει (Ξι) //Ksee - X as in foX
Ο-ο	Όμικρον// Omicron - O as in Organ
Π-π	Πει (Πι) //Pee - P as in Pet
Ρ-ρ	Ρω (ρο/Rho - R as in Rhapsody
Σ-σ/ς	Σίγμα Sigma
Τ-τ	Ταυ // Taf - T as in Table
Υ-υ	Ύψιλον//Ypsilon - EE as in sEE
Φ-φ	Φει (φι) //Fee - F as in Fun
Χ-χ	Χει (Χι) //Chee - H as in Hurry
Ψ-ψ	ψει (ψι) /Psee - PS as in liPStick
Ω-ω	Ωμέγα //Omega - O as in Organ
λουλούδι (n)	flower
δάδα (f)	torch
ποπ κορν (n)	popcorn
γράμμα (n)	letter
ύμνοσ (m)	hymn
κακό (n)	bad
# Basics 1
Singular masculine	ο
Plural masculine	οι
Singular feminine	η
Plural feminine	οι
Singular neuter	το
Plural neuter	τα
(Εγώ) είμαι	I am
(Εσύ) είσαι	you are (singular)
(Αυτός, αυτή, αυτό) είναι	he, she or it is
(Εμείς) είμαστε	we are
(Εσεί) είσαστε	you are(plural)
(Αυτοί, αυτές, αυτοί) είναι	they are
άστρασ (m)	man
μήλο (n)	apple
αγόρι (n)	boy
μικρό	small
ψομί (n)	bread
κορίτσι (n)	girl
γυναίκα (f)	woman
πίνω (v)	to drink
γεγονός (m)	fact
ωκεανός (m)	ocean
ψυχή (f)	soul
χρώμα (f)	color
ξυλόφωνο (n)	xylophone
# Basics 2
nom. indef. masc. sing. article	ένας
nom. indef. fem. sing. article	μία or μια
nom. indef. neut. sing. article	ένα
gen. indef. masc. sing. article	ενός
gen. indef. fem. sing. article	μίας or μιας
gen. indef. neut. sing. article	ενός
acc. indef. masc. sing. article	ένα or έναν
acc. indef. fem. sing. article	μία or μια
acc. indef. neut. sing. article	ένα
nom. indef. masc. plural article	μερικοί
nom. indef. fem. plural article	μερικές
nom. indef. neut. plural article	μερικά
gen. indef. (masc./fem./neut.) plural article	μερικών
acc. indef. masc. plural article	μερικούς
acc. indef. fem. plural article	μερικές
acc. indef. neut. plural article	μερικά
voc. indef. masc. plural article	μερικοί
voc. indef. fem. plural article	μερικές
voc. indef. neut. plural article	μερικά
εγώ	I
εσύ	you
αυτός/αυτή/αυτό	he/she/it
εμείς	we
εσείς	you
αυτοί/αυτές	they (masculine/feminine)
ζωή (f)	life
ρύζι (n)	rice
εφημερίδα (f)	newspaper
μενού (n)	menu
διαβάζω	to read
βιβλίο (n)	book
θα	will - verb auxiliary
# Phrases
Καλημέρα	Good Morning
Καληνύχτα / Καλό βράδυ	Good night
Καλησπέρα	Good evening
Όχι	No
Ναι	Yes
Ευχαριστώ	Thanks / Thank you
Παρακαλώ	Please / You are welcome
Λυπάμαι	I am sorry
Συγνώμη	Sorry / Excuse me
Αντίο	Goodbye
Σ' αγαπώ / Σε αγαπώ	I love you
Γεια	Hi / Hello
Τι κάνεις;	How are you? / What are you doing?
Πόσο κάνει; / Πόσο κοστίζει;	How much does it cost?
Εγώ είμαι ο / η .....	I am ....
Εγώ ζω (or μένω) στον / στην / στο ....	I live in .....
θέλω (v)	to want
δεν	not, negation
όνομα (n)	name
μιλώ (v)	to speak
Ελληνικα	Greek
λέω (v)	to say
# Food
ψωμί (n)	bread
τυρί (n)	cheese
τομάτα / ντομάτα (f)	tomato
αγγούρι (f)	cucumber
σαλάτα (f)	salad
φαγητό (n)	food
τροφή (f)	food
σουβλάκι / καλαμάκι (n)	suvlaki
γύρος (m)	gyros
κουτάλι (n)	spoon
μαχαίρι (n)	knife
πιρούνι (n)	fork
πιάτο (n)	dish / plate
καλή όρεξη	bon appetit
ένα ποτήρι ...	a glass of ...
νερό (n)	water
κρασί (n)	wine
μπίρα / μπύρα (f)	beer
ούζο (n)	ouzo
Στην υγειά σου / Στην υγειά μας	Cheers
κέτσαπ (n)	ketchup
κεφτέσ (m)	meatball
λουκάνικο (n)	sausage
πιπέρι (n)	pepper
καρπούζι (n)	watermelon
πεπόνι (n)	melon
πατάτα (f)	potato
χυμόσ (m)	juice
πορτοκάλι (n)	orange
τσάι (n)	tea
φράουλα (f)	strawberry
χάμπουργκερ (n)	hamburger
μπριζόλα (f)	steak
κεράσι (n)	cherry
σταφύλι (n)	grape
αχλαδι (f)	pear
βοδινό (n)	beef
νόστιμο	delicious
χορτοφάγοσ (m)	vegetarian
κρέασ (n)	meat
κοτόπουλο (n)	chicken
αυγό (n)	eg
σούπα (f)	egg
ψάρι (n)	fish
δείπνο (n)	dinner
ροδάκινο (n)	peach
λεμόνι (n)	lemon
ποτήρι (n)	glass
φρούτο (n)	fruit
πίτσα (f)	pizza
κρεμμύδι (n)	onion
σκόρδο (n)	garlic
πορτοκαλάδα (f)	orangeade
πρωινο (n)	breakfast
παγωτό (n)	ice cream
γλυκό (n)	candy
καρότο (n)	carrot
χοιρινό (n)	pork
γεύμα (n)	meal
κέικ (n)	cake
καφές (m)	coffee
τσίζκεικ (n)	cheesecake
ζάχαρη (n)	sugar
σάντουιτς (m)	sandwich
# Animals 1
σκύλος / σκυλί (m/n)	dog
γάτα (f)	cat
ποντίκι (n)	mouse
μέλισσα (f)	bee
πεταλούδα (f)	butterfly
αρκούδα (f)	bear
λύκος (m)	wolf
καμήλα (f)	camel
πουλί (n)	bird
αετός (m)	eagle
γεράκι (n)	hawk
δελφίνι (n)	dolphin
φάλαινα (f)	whale
καρχαρίας (m)	shark
κότα (f)	hen
έντομο (n)	insect
πίθηκος (m)	ape
άλογο (n)	horse
λαγός (m)	hare
αλεπού (f)	fox
τίγρης (m)	tiger
θηλαστικό (n)	mammal
πάπια (f)	duck
ζώο (n)	animal
ερπετό (n)	reptile
σκύλος (m)	dog
κουτάβι (n)	puppy
χάμστερ (n)	hamster
καμηλοπάρδαλη (f)	giraffe
ελέφαντας (m)	elephant
χελώνα (f)	turtle
λιοντάρι (n)	lion
καβούρι (n)	crab
αράχνη (f)	spider
κατοικίδιο (n)	pet
πελεκάνος (m)	pelican
# Possess.
my (single object)	(Δικός/Δική/Δικό) μου
your (single object)	(Δικός/Δική/Δικό) σου
his (single object)	(Δικός/Δική/Δικό) του
her (single object)	(Δικός/Δική/Δικό) της
its (single object)	(Δικός/Δική/Δικό) του
our (single object)	(Δικός/Δική/Δικό) μας
your (pl.) (single object)	(Δικός/Δική/Δικό) σας
their (single object)	(Δικός/Δική/Δικό) τους
my (many objects)	(Δικοί/Δικές/Δικά) μου
your (many objects)	(Δικοί/Δικές/Δικά) σου
his (many objects)	(Δικοί/Δικές/Δικά) του
her (many objects)	(Δικοί/Δικές/Δικά) της
its (many objects)	(Δικοί/Δικές/Δικά) του
our (many objects)	(Δικοί/Δικές/Δικά) μας
your (pl.) (many objects)	(Δικοί/Δικές/Δικά) σας
their (many objects)	(Δικοί/Δικές/Δικά) τους
# Clothing
καπέλο	hat
κασκόλ	scarf
σκούφος	skull cap
μπλούζα	T-shirt
πουκάμισο	shirt
ζακέτα	jacket / sweater
φανέλα	jersey
παντελόνι	trousers / pants
τζιν	jeans
παπούτσι / παπούτσια	shoe / shoes
κάλτσα / κάλτσες	sock / socks
γάντι / γάντια	glove / gloves
κοστούμι (n)	suit
τα ρούχα	the clothes
μιτοθφάν	jacket
φοράω	to wear
ζώνη (f)	belt
κόσμημα (n!)	jewel
μπότα (f)	boot
κάλτσα (f)	sock
παπούτσι (n)	shoe
γραβάτα (f)	tie
μάλλινος (m)	woolen thing
τσέπη (f)	pocket
πορτοφόλι (n)	wallet
δερμάτιν|ος|η|ο	leather adj.
# POS
άρθρο	article
επίδετο	adjective
ουσιαστικό	noun
λογός	speech
μέρος	part
ρήμα	verb
μετοχή	participle
πρόθεση	preposition
σύνδεσμος	conjunction
επίρρημα	adverb
αντωνυμία	pronoun
επιφώνημα	interjection
nom. def. masc. sing. article	ο
nom. def. fem. sing. article	η
nom. def. neut. sing. article	το
gen. def. masc. sing. article	του
gen. def. fem. sing. article	της
gen. def. neut. sing. article	του
nom. def. masc. plural article	οι
nom. def. fem. plural article	οι
nom. def. neut. plural article	τα
gen. def. plural article (masc./fem./neut.)	των
acc. def. masc. plural article	τους
acc. def. fem. plural article	τις
acc. def. neut. plural article	τα
# Questions
τί	what
πώς	how
πού	where
γιατί	why
πότε	when
πόσο	how much (masculine)
πόσα	how much (feminine)
ποιός	who
ποιανού	whose
ερώτηση	question
απάντηση	answer
έχει	has
# Pers. pron
της	her
τους	them
μας	us
του	him
μου	me
σου	you
σας	you [polite type]
# Aux. V.
έχω	have (I)
είμαι	am (I)
έχεις	have (you)
είσαι	are (you)
εσύ	you
εγώ	I
είναι	is (he/she/it)
έχει	has (he/se/it)
αυτός	he
αυτή	she
αυτό	it
είμαστε	we
αυτά	these
είσαστε	are (you plural)
έχουμε	are (we)
έχετε	have (you)
έχουν	have (they)
εμείς	we
εσείς	you (plural)
αυτοί	they
αυτές	they (feminine)
# Verbs Pr. 1
γράφω	I write
είμαι	I am
βλέπω	I see
κολυμπώ	I swim
τρέχει	He/She/It runs
περπατώ	I walk
υπάρχω	I exist
μαγειρεύω	I cook
θέλω	I want
κοιμάμαι	I sleep
θέλει	He/She/It wants
αγοράζω	I buy
τρέχω	I run
πηγαίνω	I go
πληρώνω	I pay
πληρώνει	He/She/It pays
πηγαίνει	He/She/It goes
παίζει	He/She/It plays
αρέσει	He/She/It likes
τραγουδώ	I sing
παίζω	I play
χρησιμοποιώ	I use
αγγίζω	I touch
αγαπά	He/She/It loves
βρέχει	It rains
αγαπάω	I love
απαγορεύω	I forbid
λέω	I tell
λέει	He/She/It tells
ακούει	He/She/It hears
χρειάζομαι	I need
φέρνω	I bring
ακούω	I hear
δουλεύω	I work
βοηθώ	I help
δείχνω	I show
κάνω	I do
φτιάχνω	I create
βάζω	I put
βρίσκω	I find
σχεδιάζω	I plan
παίρνω	I take
ξέρω	I know
# Colors
κόκκινο	red
πορτοκαλί	orange
άσπρο	white
μαύρο	black
μπλε	blue
κίτρινο	yellow
πράσινο	green
άσπρη	white (feminine)
ροζ	pink
πολύχρωμο	colorful
λαχανί	light green
μοβ	purple
γαλάζιο	light blue
χρώμα	color
ασπρόμαυρο	black and white
καφέ	brown
κίτρινος	yellow (masculine)
κόκκινος	red (masculine)
πράσινος	green (masculine)
μαύρος	black (masculine)
ανοιχτός	light (masculine)
σκούρος	dark (masculine)
# Determiners
εκείνος	that (male)
εκείνη	that (female)
εκείνο	that (neuter)
# Genitive
genitive plural ending	-ων
articles for genitive	m: του f: της n: του
# Prepositions
από	from
σε	to (prep.)
ανάμεσα	between
δίπλα	next to
για	for
σαν	like; to be like
πριν	before
μετά	after
πάνω	on/above
κάτω	down/below
εντός	in
μέσα	in
εκτός	out
έξω	out
κοντά	near
εναντίον	against
# Places
πόλη	city
χωριό	village
πλατεία	square
κέντρο	downtown
κωμόπολη	town
εκκλησία	church
δημαρχείο	town hall
παραλία	beach
ακτή	coast
δρόμος	road
σπίτι	house
εστιατόριο	restaurant
# Time
μέρα	day
εβδομάδα	week
Δευτέρα	Monday
Τρίτη	Tuesday
Τετάρτη	Wednesday
Πέμπτη	Thursday
Παρασκευή	Friday
Σάββατο	Saturday
Κυριακή	Sunday
σαββατοκύριακο	weekend
μήνας	month
χρόνος	year
Ιανουάριος/Γενάρης*	January
Φεβρουάριος/Φλεβάρης*	February
Μάρτιος/Μάρτης*	March
Απρίλιος/Απρίλης*	April
Μάιος/Μάης*	May
Ιούνιος	June
Ιούλιος	July
Αύγουστος	August
Σεπτέμβριος/Σεπτέμβρης*	September
Οκτώβριος/Οκτώβρης*	October
Νοέμβριος/Νοέμβρης*	November
Δεκέμβριος/Δεκέμβρης*	December
εποχή	season
Χειμώνας	winter
Άνοιξη	spring
Καλοκαίρι	summer
Φθινόπωρο	autumn
Τι ώρα είναι;	What time is it?
# Occupations
ο εργάτης / η εργάτης / η εργάτρια	the worker
ο ναύτης / η ναύτης	the sailor
ο αγρότης / η αγρότισσα	the farmer
ο οδηγός / η οδηγός	the driver
ο δάσκαλος / η δασκάλα	the teacher (elementary school)
ο καθηγητής / η καθηγήτρια	the teacher (middle school & university)
ο μαθητής / η μαθήτρια	the student (school)
ο φοιτητής / η φοιτήτρια	the student (university)
ο μεταφραστής / η μεταφράστρια	the translator
ο γιατρός / ο ιατρός / η γιατρός / η ιατρός	the doctor
ο ηθοποιός / η ηθοποιός	the actor / the actress
ο αστυνομικός / ο αστυνόμος / η αστυνομικός / η αστυνόμος	the policeman / the policewoman
ο πωλητής / η πωλήτρια	the salesman / the saleswoman
ο δικαστής / η δικαστής	the judge
ο δικηγόρος / η δικηγόρος	the lawyer
ο διευθυντής / η διευθύντρια	the director/ the principal (school)
ο στρατιώτης / η στρατιωτίνα	the soldier
ο μάγειρας / η μαγείρισσα	the cook
# Conjunctions
και / κι	and
ή	or
ούτε	neither
ούτε...ούτε	neither … nor
είτε...είτε	either ...or
αλλά	but
όμως	however
ενώ	while
όταν	when
πριν	before
γιατί	why***
επειδή	because
αν	if/whether
να	to
για να	in order to
που, πως, ότι*	that
γιατί, επειδή, διό*τι	because
